00 00 00 00 00 00 00 00 00 00 00 00 00 00 00 00 00 00 00 00 00 00 00 00 00 
00 00 00 00 00 00 00 00 00 00 00 00 00 00 00 00 00 00 00 00 00 00 00 00 00 
00 00 00 00 00 00 602 601 603 00 00 00 00 00 00 00 00 00 00 00 00 00 00 00 00 
00 00 00 00 00 600 00 00 00 00 00 00 00 00 00 00 00 00 00 00 00 00 00 00 00 
00 00 00 00 600 00 00 00 00 00 00 00 00 00 602 601 603 00 00 00 00 00 00 00 00 
601 601 603 00 00 00 00 00 00 00 00 00 00 600 00 00 00 600 00 00 00 00 00 00 00 
00 00 00 600 00 00 00 00 00 00 00 00 60 00 00 00 00 00 600 00 00 00 00 00 00 
00 00 00 00 600 00 00 00 00 00 00 00 60 00 00 00 00 00 00 600 00 00 00 00 00 
00 00 00 00 00 600 00 00 00 00 00 00 60 00 00 00 00 00 00 00 600 00 00 00 00 
00 00 00 00 00 00 600 00 00 00 00 00 60 00 00 00 00 00 00 00 00 600 00 00 00 
60 60 60 60 60 60 60 60 60 60 60 60 60 60 60 60 60 60 60 60 60 60 60 60 60 
60 60 60 60 60 60 60 60 60 60 60 60 60 60 60 60 60 60 60 60 60 60 60 60 60 