00 00 00 00 00 00 00 00 00 00 00 00 00 00 00 00 00 00 00 00 00 00 00 00 00 
00 00 00 00 00 00 00 00 00 00 00 00 00 00 00 00 00 00 00 00 00 00 00 00 00 
00 00 00 00 00 00 00 00 00 00 00 00 00 00 00 00 00 00 00 00 00 00 00 00 00 
00 00 00 00 00 702 701 703 00 00 00 00 00 00 00 00 00 00 00 00 00 00 00 00 00 
00 00 00 00 700 00 00 00 00 00 00 00 00 00 00 00 00 00 00 00 00 00 00 00 00 
00 00 00 700 00 00 00 00 00 00 00 00 00 00 00 00 00 00 00 00 00 00 00 00 00 
701 701 703 00 00 00 00 00 00 00 00 00 00 00 00 00 00 00 00 00 00 00 702 701 701 
00 00 00 700 000 00 00 00 00 00 00 00 00 00 00 00 00 00 00 00 00 700 00 00 00 
00 00 00 00 700 00 00 00 00 00 1013 1014 00 00 00 00 00 00 00 00 700 00 00 00 00 
00 00 00 00 00 700 00 00 00 00 1015 1016 00 00 00 00 00 00 00 700 00 00 00 00 00 
70 70 70 70 70 70 70 70 70 70 70 70 70 70 70 70 70 70 70 70 70 70 70 70 70
70 70 70 70 70 70 70 70 70 70 70 70 70 70 70 70 70 70 70 70 70 70 70 70 70